11111111111111111111
1S000000010000000001
10000000010000000001
10000000010000000001
10000000010000000001
10000011110000000001
10000000000000001111
10000011111000000001
10000000000000000001
10000000000000000001
10000000000000000001
11111111111111111111