11111111111111111111
10000000010000000001
10110111010111011101
10S00000000000000001
10111101011101011101
1000000100B001000001
11101111111111110111
11100011000110000111
10001000010000110001
10111111010111111101
10000000000000000001
11111111111111111111