1111111111111111111111111111111111111111
1000000000100000000110000000010000000001
1011101110101111110110111111010111011101
1011101110101111110110111111010111011101
10S00000000000B0000000000000000000000001
1011010111110101111111111010111110101101
1011010111110101111111111010111110101101
1000010001000100000110000010000000100001
1111010101011111110110111111101010101111
1111010100000010000000000100001010101111
1111010101111010111D11110101111010101111
0000000001000000100000010000001000000000
1111010111011110111111110111101110101111
1111010000000010000000000100000000101111
1111010111111010111111110101111110101111
1000000001000000000110000000001000000001
1011011101011111110110111111101011101101
1001000000000000000000000000000000001001
1101010111111010111111110101111110101011
1000010000100010000110000100010000100001
1011111110101111110110111111010111111101
1011111110101111110110111111010111111101
1000000000000000000000000000000000000001
1111111111111111111111111111111111111111