111111111111111111111111
100000000000100000000001
101110111110101111011101
1S00B0000000000000000001
101110111110101111011101
100010100000000001010001
111010101111D11101010111
000000001HBHHHB100000000
111010101111111101010111
111010101111111101010111
100000100000000001000001
101110111110101111011101
100000000000000000000001
101110111110101111011101
100000000000100000000001
111111111111111111111111
